10 10
1 1 0 0 0 0 0 1 0 0
0 0 0 0 1 0 1 1 0 0
4 0 1 0 1 0 1 0 0 0
0 0 1 0 1 0 1 0 1 0
0 0 1 1 1 0 1 0 1 0
0 0 0 0 0 0 0 0 1 0
0 0 1 1 0 0 0 1 1 0
0 0 1 0 0 0 0 1 5 0
0 0 0 0 0 0 0 1 0 0
0 0 0 0 0 0 0 1 0 0
3 1
8 9